A=####==A
=## H ##=
=I# H ###
#= =#= =#
#HH#G#HH#
#= =#= =#
### H ##=
=## H ##=
A==####=A