    ===###
  #==# ###
 ==G#I====
#===#=== #
 #==     =
   #   # =
   ####==#
   ###  #
  #####