            A
     ###  ###
     #A#####H
   #####  ##
   #G#H   ##
 #####   ####
##I#     ####
####  #####
     ###
     ###