##A  X##HHHHO#
###   =     ##G
###H#======
    ==#=#== ###
   I======###HA
#A##======= ###
### #=#====  #
### =====#=# #
    #   ==####
 A###   ==N