      ###
      ##  ###
A#######  #G#
 #H #  #  ###
 ## #  #  HH
  #A###I#####
   H H   # ##
   H H  #####
   HHHH######