###A       ###B
#    ##I  ####
###X####### ##
####   # ### #
#  #   H  ## #
#  N#G #   O #
#    ####### #
###  H#H  ## #
###   # #### #
 ###### A###E#