#W###
#   #H      #A#
#  ##### ######
#  #=I=# #  #A#
#  ##### #
#  H# #H #
##### #  #HH###
###   ####  ##G
#A#   ####  ###