       B
##B#   #
#####  #
#BI#####HH##HH#
#####H  #   #
##B#    #   #
#       B  ###
#         ##G#
#HHA      ####