###        #A#
A##        ###
##HI##  ######
    ######
     A##
   ## ## ##
   ########
###H##HH##H###
###   G    A##
#A#        ###