   ###A##   ###
   #    ### ###
  G#### ### A #
#### H# ##    #
#### H# ####  #
## ####  # ## #
 I####   # ####
   #     #  ###
   #== ==#  ###
    ######