# G##
# ###
#####
#####
I ###
# ###