        ####
        ####
###     #  ####
#I#######   #G#
###    ##A  ###
###    ###  ###
 ##H   #
  ######