      ====  ###
HGH   ====  #A#
HHH   #  #==###
HHH#===B     #
   =====     #
   ##==#     #
   ====####  #
#A#===#=##A# #
###I  ===  ###
###   === A###