 #I     ####
###     #G##
###     ###
###      #
#        #
###=# ## #
###=######
   ####