I===       ===A
=#== ===== =X==
==== =A=== ====
===A =H==H ===O
===# ==G== ==#=
==A= ===H= #===
==== ==H=X ===#
#O== ===== ====
===#       ==#=