     ###
    #####
    #####
    ##  #
###     ###
#G##    ###
####     #####I
  #####  #
    ###  #
    ######