#=#    ###A###
==A##A###   ##
#=H#     ####S#
 # I###A##  ###
 # #   # #  ##
 ###B#==## ###
A##   =### ##
##     #H   ##
####   ######HG
 ########  HHH