###
###      ####
#G#    I ####
  #### # #  ##
     # # #  O#
 #####O# #  XS
 #  #X####   #
 #       #   #
 ###S    #   #
    ##########