        ##AA##
####    ##  ##
#  #  ########
A  #G #H   #
#  IO##V## #HH
### # #  # ###
### X #  # #
N   # # ######
###HH## ##  ##
        ##  B#