I########
# ##   ##
# ##    #
#     ###
#     ##G#
##########
  ##