####        ###
## #        #HG
## #AI==#   #H#
 # ###A===# #
 #  # # ==#==
 #### #   #==
 ###  #W### H
         #  ###
         #  ##A
         ######