 I#############
G    ##  #   ##
#    ##  #   ##
########A######
H #   #   # # #
HH#  ###  #A# #
######A#  ### #
 HH# ###  ### B
       #### ###