  ###
  ###A   GH#
  ##H    ###
##  ##   ##I
##  ##     #
############
  H      #  ###
  ###    #  ##A
  ##A    ######
  ###