I#####   ######
#H===##A##H===#
######   ######
 #  ##HG ##  #
 A  #==#==#  A
 #  ## # ##  #
######   ######
#===H##A##===##
######   ######