###
#I#######H  ###
###    H#####G#
###         AA#
###
###
###   H#####A
########H  ##
#B#        ##
###        #A