I=#HG   #=A#
#=#H    #=##
#=###   #=##
#  #=   #  #
#  #= A #  #
#= ######  #
#=  ##H#   #
############