    ####A######
##  I     #####
### ##  ###  ##
###A##  ###H #
#  # ##### H #
#  #     #####B
###W ####N H
  #  ##   ###
  #  ##   #G##
  ####    ####