         B
         #
        #######
        ##   ##
        ##   ##
        ==   ##
 #########   ##
##     I##   ##
G#H    ########
##H