 ==##HHGHH##==
#=# ##   ## #=#
=== ##   ## ===
==A#==###==#===
=== ==#I#== ===
===#==###==#=A=
=== ======= ===
=== ======= ===
#=# ==# #== #=#
 ==#==   ==#==