###        H###
X#G AA##  ##O##
###  # # ## ###
     # # ##
######I########
H   #  #  #   #
H   #  #  #   #
### ###########
###       ##
#A#       ##