 ============
====== =====G=
== #===== ===#
========#=====
==============
========= ====
=I =========##
 ==#====#====