#O#### ######A#
#====# #    ###
#=  =# ########
#=  =# #
#====# #######
###A####     ##
       #     #B
######## HXH
##A    I #H#
######## H#G