      G
      #
# A## # ###HA
 ===# # #===
#=#=#####=I=#
A===# # #==HA
#H# # # # ###
  #   #    #H
  #   #    #H
  #HHH##HHH##