G          ##
# I#### A  ##
#  ###########
#  ##   # #  H
###H  ### B  H
#   ####     #
X   ###  #O# #
###  ### ### #
 ####### #####