     ###A
##   ###E###
##   #    ###
##   #      ##
#H#######H##=#
# I###   H## #
H    A    ##=#
###    ## ####
##O    G##   A
###  X####