###W#       ==#
A#E###E#######N
#      # #    #
# G    # #    #
# I#########  #
# # #    # A###
# ###X   # #  #
#  N#  OE###  #
#  ##  ##H  ###
######H###  ###