###    ###
#I###### ##
# #  ### #G#
# ###### ###
# ####   ##
###      ##
 ##########