 #H########
 AH#     N###
 ##I##W   # #
   # #   ## #
####### ### #
#  # ###### ##
#  #  H## # ##
G  # #### ####
#### ###   ##A
     #A#