 ##E#H######A
 #       #
 #I###   ####
 #   #   #  #
 #   #  =#  A##
 #  ######  ###
#OG A  ###
# H H  ###  #A#
# # H   #   ###
##X #####HH####