      #==HH##G
 I##  H##   ##
  ##  H##   HH
  ###########
     #=     #
     #      #
#A#  #  #A==#
###  #  #===#
#########==A#
           =#