######
#I####
######
####G#
######