     ======
###G ====#==E##
# ===#=  =#  ##
# ==I==###N  ##
# =====  #    #
#  =#=   #    #
#   #   ###   #
### #   E## ###
##X ####### O##
###         ###