#A=====O=A====
=HHI==  ======
======  ======
=====X  ======
=#====  #===#=
======  ====H=
=HHH#=  ====HA
==G===O===X===