  #H##B   ####
### ##H##X#  #
### ##H   #B##
  #  =#####  #
  #=##GI  #HH#
  #  ######HHO
  ###     #  #
  ###=A#  ##B#
    ####  #  #
     ###  ####