    B    ##
    #   ######
I##########  #
N A          #
###          #
###     ##A  #
#  HGH  ## ###
##############
S  HH      ##
#           A