G##           #
###           A
########      #
      HH      #
      HH      #
      ##      #
   A ===HHHHI##
   =====    ###
   =====    ###
     #==