        ##
       ###
##  ######
#I####  #
####    #   ###
 ##     A####G#
  #     A#  ###
  ###H  ##
   ###  ##
   H######