       I
     #####
    #=#=B##
#A# ##HHH=# #=#
==##=#HGH#=##==
#=# #=HHH## #A#
    ##B=#=#
     #####