  ###      G  S
 ##A#######H###
 ### ##I   H  #
## ##  #W##H###
## #=  #      #
#  =##E###    #
## ### ####   #
##     ## ##  A
###A##### ##  #
           ####