   ###   ######
   A##   A##  N
   ## ## ###  H
#### ###  #   #
# ## ###I######
# ##   ###   ##
#  ##B ##    S#
##     #   A##=
##     #   ##
########HHH###G