     B      X#O
     #      ###
A#########I #A#
  # #  ##O#
  # #  ######
#W#E#X     G#H
#    ###    #HH
###  ###     ##
##A    S     ##
###    ###H###