        ###
   ###  ###
#HH#I#########
#HH###      A#
#           ##
#           ##
#       ######
#####   ###
 ##G#   ###
  ###   #####A