 A##    #E# ###
#=====  XHG ###
#=====  #H# #A#
#==I==#     #
 =====#===#A#
 =====#===###
 H ###    ###
#H#    ###  #
##O    A##  #
###    ######