      #######
####  ###  ##
#########  ####
#I##       ##G#
####       ####
            ###