              A
       S  G#H##
  ######  H####
 A##   S  H  #
    ###I  H  #
### #  #  X  #
A## #  #     #
### #  #    ###
  #H#  S    A##
  #H#  #######O