  ### ###H
G ### ###H
S N   #  A
# A#  #
H #####I######
H ##  #     ##
S ##  #     #A
#  #  ##     #
#########    #
      ########