 I#############
     #      ###
     #       ##
 H#X###OH#   #
###      ##  ##
##A  ### ##  #B
  #  G#####  #
B##  ###     ##
  ###       ###
   ####H#######