    ##   ==#
    ==  ==I==
#HHG##=####==
=# ===  #== #AA
=#     O    #H#
 X     #    #H#
       ###  # #
 ##########H###
 A##     ######
 ###