    ####
    #  H  X
###O#  H  # ###
#   # I#### A##
# #### # ## ###
###### # ##   #
  ###  #  #####
       ####  ##
    G######  ##