==I
==##########=
          A==
=#########==
=##  HH  #==
 #=G==#  # #
 #= ==#### #
=##        #
=###########