  ##
  ###
  ##B     ###H
   ####H  #G#H
      ##HH###
 ##   ##
##A#VV##
#I#   ##   ###
###   ##B#####
           ###