  ### ##
 # ### ##
# #I##  #
# #### ###
###   ####
# ########
#G#####