X#A         O##
###       O ##A
##O I###### #X#
     X#####
     ##  ##
     ##  ##
#X## ########
#==# X##### HHH
A==O  O     ##G
####        ###