A##
###########==
##  ==  == ==
 #  ==  == B=
 H    ##   ==
 H   #GIVV#=#
 #    ##  H==
 #==      H==
 =##########
  A