 ######H
 ##H   H     A
 H    ###    #
 H    #G#    #
E###A#I##A####W
 # #  # #  # #
 # #  ###  # #
 # #W#E#  ####
 ###   #B ##A#
 ###   ## ###