 I       ######
 ###     #  ##A
A###     H  ###
 ##### ==H
    #####
     ==#####
 A   ==   #####
##H  H==    #G#
#####H==    ###
###          HH