##H         #A#
XHG    ###  ###
#H# #### #  ###
    # ####    #
 ######I#######
 #   #### # #
 #   # #### #
###  ###   ###
##A    #   ###
###    O   #A#