     ######
     #  ###
     #  #####
I#####     ####
    ###    ##G#
    ###     ###
      #  ##
      #####
      #####
       ###