###    ########
#I#########  ##
###    ##    ##
            #A#
            ##
###  ====#  BB
#G#=======  ###
###=========###
     =======###
      V##V