         #G
         ##
##############W
#     # # #  #
#     B # H  H
#     # I H  H
===#= #   ####
===== ### #HA#
#==== ##A ####
=A==#####