 I########B####
     ##      ##
     ##      ##
             ##
             ##
###  ##HH#B####
#G#  ##
###  ##
 ##  ##
 #VV######B###