     ###
####X#I########
###  ###    ###
  #         G
  #   ###   #
  #####A#   O
##     ##   ###
##   #### ##H##
########=#==