 ###V
 #G#V
 ###
 #   ######
 #   ##  ##
I######  ###
     #B    #
     ####  #
     #######
        ###