           ####
 ####VV#B####I#
 ####       ###
 ##B#
 ####
   ###B#VV###
          ####B
###       #####
#G###VV######
####