I=======
=======G
===#=# =
   === =
   === #
==#=====
========
==#