#==
#=============
===#===H==#===
 =====   ====#
 #======#=A===
 #   #====== #
 #     A=    H
 #    ###    H
 I    ###    G
      ###