 ##############
 H        # ###
 H I####### #A#
###  #====#
##A  #=  =#
###  #====#####
     ####### ##
       HHH  A#A
       G ######