I###########
#       #  #
# ## X###  #
# ## ####  ###
# #O #      ###
#=# ### ##A  ##
### H## ##   ##
### G #########