       #######
### I  #   ###
O## #  #   #A#
##HH#  #    #
    #  #    #
    #  #    #
### ######### A
G=# N    #   ##
=X#      #   ##
         #W#E#