      G
      H
###   H   ###
AA#   H   #AA
######H######
 #   I##   #
 #   ###   #
 #   # #   #
 S   # #   S
 ###########