##HH#===###
##HH#===I##
#       ###
#        #
#   ###  #
####G##  #
    ###  A