 #====###
 #====G##
 ###  ###
 #
 #
 #
 #    ##
###   ##
I#######
