     ##B###
     ######H
###  B##B#####
#I#######BB##B
     ##B##B###
     ######B##
###  ######B###
#G#VV#B#  ###BA
###  ###   ####
###         ###