        ##  #G#
        ##  ###
 ####I##### #XH
 #    #  #=
 #    #  A= ###
 A  ###  #HH##A
 #HH##   #  ###
 ## ######
O##