  =========A
============
============
  =I========
  =========H
============
G===========
H===========
 =======A===