##=##   ##=##
##### O #####
# # # # A H #
A # # H # H A
# X ##### # #
# H ##### O #
# H # # # # #
I#G## X #####
##=##   ##=##