   I##     ####
   ##B ##HH####
#HH### #    ###
#      #    #
#     ###H  B
#     #G## ##
###   ###  ###B
###        ####
 ##B     ####
 ####HH######