###G H#     ##A
#    H#     ###
# ######AI##  #
# #   #    N  H
# ###########A#
# ##  ###  #  #
# ##   ###B#W #
#   #A#       S
#######     ###
HHH ##########