I###########B
###BB##BNB###
B########B#B#
##B##B###B###
#B######BHB##
#A##B#B#HGH#=
##B#B##B#H=B#
######A#B#=##