     ##    ###
   ######  #G#
######B#######
#I##B  #####H
###      ###
 #        #
 #        #
 #H      ##
 ##      ##
  A      A