      ####  ###
####  ##A#  #G#
##B#  ####  ###
####  ####  ###
#I##  ####HH###
####HH####