      ###  ###
   I  ##A  ####
   # A ##  #  #
###### #   #  #
#  ### #  ##  #
#    # #  ##  #
######E####  ##
 H   #  ###H###
 H   #HH#   #A#
 G   ####   ###