   I##
   ###
####
## #
## ####
 # #  #
 # #  #
## =###
#G####
##