   A###    ##B
   ##A#########
   # ##      ##
#I## #       ##
# O# ##B  HHH
# ## #   GHH#
# ######    #
##   # # ##B###
##   # # ##  =#
######## ##X###