      ###   ##B
    O ###   ###
    # ##A   H
    #  HH   H
X##############
 #   ## # #   #
 # HH## # #   #
 I #### ### #A#
  #G#   ##A ###
  ###   ### ###