A#####=#####A
##    H    ##
##    HH   ##
=#HHH###HHH#=
##   #G#   ##
##   ###   ##
##    H    ##
##    H    ##
#############
AI####=#####A