     ##     ##
     ###    ##
#W#####==HH##A
# #    ##
# #    ##E#I
#E#####A
    ## #   #O#
#X# ## ##HH###
### ##E#   ###
#G#