#A=#===     ###
=======     ##A
#=## #####==###
     #===#
     #=I=#
    HH===#
    =##### X###
  ##=      #==#
  O##      #=G#
  ###      ####