 ##########O
 N# ##H  ### A
 ######  #A# #
 ##  A#      #
 #   IG    ###
 #############
 # ###H      #
E###  X      #
 #    #    ###
 #HH####HH####