        ##  ###
  I###  ##  #=#
  #  #  HA ####
##E# ####  ## #
#### ####  #A##
   #    #  #  #
#A##    #######
##O ##X #  #
### GH# ####
    #H#