 A  #A#
##  ##W########
## ####   I   #
#HH#      #   #
   #      # #H#
   ######## ##H
   #  ##    #G#
  #A# ##
  ######
  ###