I##    ######G
 ###   H
  ##   H ###A
##########   X
### #  #######
  # #  #  #  #
  #### H  #  #
    ## #  O###
    ## ##=  ##
      A#######