###=####=####
##        ###
##         ###
###   ###  #I#
###===#G#  ###
###  =###  #
  #  =====##
  ###==#===
   ##======
   ###  ##