            #A
  ##VV##   ###
 ###HH##  #A##
 #G#   #####
 ###    ###
         ##
    ###  #I
##HH#A#  ##
##HH#######